10x30
##############################
#P T T T    A    T T T    A  #
# ############ ###############
# #A      T         A      T #
# # ##########################
# #                T         #
# ########################## #
#                            #
############################S#
##############################
